2DDrawing Index	2DDrawing 目录	2DDrawing Index
current output	当前输出
2DDrawing Index	2DDrawing 索引
Syntax	语法
2DDrawing Index	2DDrawing 目录
Inkey()	Inkey()
BASIC	BASIC
Team Blog	团队博客 
Bug-fix 	BUG修复
development environment	开发环境
offlineordering.htm	http://www.purebasic.com/offlineordering.php
onlineordering.htm	http://www.purebasic.com/onlineordering.php
Database programming 	数据库编程	Database programming 
optional	可选
Index	索引
cross-platform	跨平台
Programming language 	编程语言
serial port	串口
the given window	指定
General	常规	常规
Introduction	简介
Will print	将打印
Define	Define	大写是关键词
Will display 	将显示
will display	将显示
Fantaisie Software	Fantaisie Software	原公司名称
